111111111111
1E1110C00001
10011P111111
10111011C111
100C00000111
100000000001
111111111111
