11111111
1E1000C1
10111101
10001001
100P0001
11111111
