11111
1E111
11P11
10111
100C1
11111
