11111111111111111111
1C001010000010001101
100000000000000000P1
11100110111101111111
11101110111101111111
11101110111101111111
1C10111C1111000000C1
10101111111101111111
101000000000000000E1
1001111C111101111111
11011111111101111111
100000000000000000C1
11111111111111111111
