11111
1P001
10101
1C0E1
11111
